4 2 0 1 # 7 0 3 3 2 2 6 # 8 1 1 # 6 5 6
1 9 6 2 7 9 5 # 5 # 3 6 3 1 3 # 0 2 9 2
0 9 # 0 9 # 8 5 6 6 9 9 7 4 # 8 8 # 6 0
0 1 3 C 2 2 2 2 1 0 8 3 9 8 9 0 D # 6 7
# 5 8 4 5 # 8 2 4 1 3 3 1 # 0 3 # 9 6 7
3 7 8 2 8 9 7 7 7 0 1 0 6 4 8 4 2 # 0 #
0 6 # 2 # 7 6 7 7 8 6 # # # # 1 2 # 9 6
# 1 6 1 # 6 # # 4 1 9 1 2 7 1 2 # 9 6 #
6 3 8 3 1 # # 1 9 # 4 8 5 2 # 3 1 9 1 3
# 1 1 9 0 1 5 9 5 # 7 2 # # 5 # 8 2 # 7
6 # 1 # # 4 6 3 # 2 4 8 9 7 8 0 0 4 4 5
5 3 7 5 9 4 # 0 4 E 0 1 6 # 3 3 8 5 2 #
6 # 3 2 3 5 5 # 1 0 0 # 1 2 9 # 3 9 2 3
0 1 6 2 3 # 7 5 # # 8 # # 2 3 # 3 2 7 3
4 # 6 # 7 2 8 6 3 # 4 4 # 2 8 8 4 0 F 5
# 7 3 2 4 # 9 2 1 0 6 1 5 3 0 5 # # 7 5
7 3 0 B 0 # 1 6 3 1 0 5 1 3 4 8 2 2 6 #
2 2 # 2 2 2 5 1 # 4 9 3 2 6 # 4 5 # # 0
6 # 7 S 6 # 8 5 A 9 G 2 9 # 6 0 4 # 7 #
1 6 9 5 1 0 3 6 3 2 # 4 4 3 # # 8 # 8 5
