# # # # # 2 1 3 4 5 # # 1 2 3 # # 8 7 6
2 3 4 S # 5 # 6 7 8 # 4 5 # 6 7 # # 9 #
# # # 0 3 4 5 6 7 # # # 6 7 8 9 # 2 1 A
4 5 6 7 # # # # 8 9 1 2 3 4 # 5 6 7 8 #
5 6 7 8 9 # 1 2 3 # 4 5 6 # 7 8 9 1 B #
6 # 8 9 # 3 4 # 5 6 7 8 9 # # # 4 5 6 #
7 8 9 # 5 6 7 8 9 1 # 2 3 4 5 # 6 7 # C
# # # 6 7 8 9 1 2 3 # 4 5 6 7 8 9 1 2 3
8 9 1 # 8 9 1 2 3 4 5 6 7 # # # 3 4 D #
9 1 2 3 4 5 6 # 7 8 9 E 1 2 3 4 5 6 7 8
1 2 # 5 6 7 8 9 1 # 3 4 5 # 6 7 8 9 # 3
2 3 4 6 7 # # 1 2 3 4 5 6 # # # 1 2 3 4
3 # 5 7 8 9 1 2 3 # 5 6 7 8 9 1 # 4 5 2
# 5 6 8 F # 3 4 # 6 7 8 9 1 2 3 4 5 6 7
5 6 7 9 # 5 6 7 8 9 # 2 3 4 5 6 # 7 8 9
6 7 # # 7 8 9 1 2 3 4 5 6 7 8 9 1 # # G
7 # 9 1 8 # 2 3 # 5 6 7 8 9 # 2 3 4 5 #
8 9 1 2 # 4 5 6 7 8 9 1 2 3 4 5 6 7 8 9
# 1 2 3 4 5 # 8 9 # 3 4 # 6 7 8 9 1 # 2
# # # # # # # # # # # # # # # # # # # #